{
  "atlas": {
    "width": 4,
    "src": "/levels/sample/walls.png"
  },
  "entities": {},
  "map": {
    "size": { "width": 8, "length": 10 },
    "logic": {
      "start": { "x": 1, "z": 1, "look": "east" },
      "goal": { "x": 5, "z": 8 }
    },
    "types": {
      "floors": [5, 6, 1, 2, 3, 4],
      "walls": [13, 9, 10, 11, 12, 7, 8]
    },
    "tiles": [
      9, 10, 10, 10, 10, 10, 0, 0, 9, 5, 5, 5, 5, 10, 10, 7, 9, 5, 11, 5, 5, 5,
      5, 7, 9, 5, 5, 9, 7, 8, 7, 7, 9, 5, 5, 1, 1, 1, 1, 7, 9, 5, 5, 10, 1, 1,
      1, 7, 9, 5, 9, 9, 1, 1, 1, 7, 9, 5, 5, 9, 1, 1, 1, 7, 9, 5, 5, 9, 1, 4, 1,
      7, 9, 8, 8, 8, 8, 8, 13, 7
    ],
    "ceilings": [
      0, 0, 0, 0, 0, 0, 0, 0, 0, 3, 3, 3, 3, 3, 3, 0, 0, 3, 3, 3, 3, 3, 3, 0, 0,
      3, 3, 8, 8, 8, 8, 0, 0, 3, 3, 8, 8, 8, 8, 0, 0, 3, 3, 8, 8, 8, 8, 0, 0, 3,
      3, 8, 8, 8, 8, 0, 0, 3, 3, 8, 8, 8, 8, 0, 0, 3, 3, 8, 8, 8, 8, 0, 0, 0, 0,
      0, 0, 0, 0, 0
    ]
  }
}
